*******************
***************--**
*******-*********-*
*********-*********
********-*****-****
*******************
**-********-*******
****************-**
*******************
*******************
******-************
*******************
*-********-*****-**
*************-*****
*******************
*-*****************
***********-*******