********---*-
-*--***-*-***
--******-***-
-*-***--*--*-
-*-*--**-***-
-***---*****-
-**-***-****-
***-***--**-*
-***----**-*-
-***-*****--*