*****-*********-**
*************-****
********-*********
***-**************
*******-*-**---***
--**********-*****
**-**************-
*-*****--******-**