*****-**-*****
******-**-****
*--***-*******
****-**-******
****-*********
*****-******-*
**-***********
*********-****
**************
***********---
******-*******
**************
**************
*-****-*******
**************
**-***********
**-*******-***