******---*-**---*
*-*-*-**-*-*-****
******-**-*****--
****--****-*--***
**-******--******
**-*-************
**********-*****-
*-***--****-*****
***--************
****-******-****-
***-*-*--********