***-*---***-------*
*-----**-**---*-*-*
**-**--*-*---*-*-**
-****-****--***--*-
---**----**----**--
------****-----*-*-
-*-*-**------*-*-**
---*-----*--*--**-*
--*-*-**----*----**
**----*-***-*-*--*-
---**-*---*---**---
**-----*--*-*--*-*-