***-***-**-******
********-***-*-**
******-****-*-***
**-**************
***********-*****
**-******----****
****--***-*******
*-*********-*-***