***-*-**-*
--*****-**
-*******-*
******-***
*-**--**-*
***-*-**-*
*********-
-******-**
***-*-****
***-******
*******-**