***-**-***-********
********-**********
**-*****-**********
******--***-***-***
*-*******-*********
**--**-**-******-*-
*-*-***********-*-*
********-*-*******-
--********-*******-
-*****-*****---****
******-****-**-****
*-**********-******
-******-******-****
************-*-*-**