**-************--*-*
****-*-*************
**-*-***************
---**********--*-***
**-**********-****-*
-******-*-****-*****
************---***-*
-******-******-*****
*-*******-********-*
*****-************-*
-***-*-****--*-*****
*****-***********-**
**********--*****-**
********************