***---*--*
-*---*-**-
----*--**-
---**-***-
-*------**
--*-****--
-**-**-*--
**--*---*-
-*-----*--
**----**-*
*-------**
**---**--*