**-*-*------
---*--*-----
**-*--------
*-*-------*-
------------