*-***-****-
**-*-*****-
*****-*-***
****-******
****-***-*-
***-*-*****
*-****-****
-*-**-**-**
***-*******
***********
*-***---***
*-********-
***-*******
***********
-********--
-****-****-
***-**-****
**-**-*-***
---****-***