**--*---****-**
*-*-*-***--*-*-
-****-*-**--*--
-**-*--******--
**----****-*---
*********-*****
***---*--**----
---*-*****-**--
*****--*-*--***
-*-*-**-***-***
-**--*-*-*-***-
---****--*--**-