*-***-*-*****
*********-**-
***-****-****
****-********
-***-********
*****-*****-*
**********--*
**********-**
*************
**-**********
*-******-****
*************