*-****---*---***---
*----*-*--*---**--*
*-***-*----*--**-*-
*-*---**-***--****-
-*-*--**-****--**-*
***-**-**----***---
**-*--***-****----*
-****---**-***-****
--******-*-*-*---*-
-*---***--*--****-*
-**-**-*******-*-*-
------*--**---***-*
*------**--**-****-
*--*------*---*-***