**--**
******
*-*-**
****-*
-**-*-
***--*
***-**
***-**
**-***