**-****-***-***-**
***********--**---
*-***-**--*-----**
***--*********-***
-**-******---*****
*******-*****-**-*
****---****-*--*-*
-***--************
*****--**-**-***-*