**-*--****-***
*--**-**-****-
******-*******
***********---
**-***********
******-*******
*****--****-**
-*****-*-**--*
-*******--****
-*-*-****-****
**-***********
-****--****-**
*******--*****
*-**-*****-*--
*-****-**-*-*-
****-**-*-****
-**-**-****-**
**************
********-*****
**-*****-**-**