*--------
-------*-
-------*-
---------
-*-*-*---
--***-*--
-*-------
-***-----
---------
--*------
---------
---------
---------
---------
---------
----*----