*--*--**------*--*
--******---*-****-
---*-*-*-***----*-
*----*-**---**-*--
-*---*--*-*----*--
---**--**--**-*-*-
**-*--*-*----**-*-
-*-*-*-**-*-******
*-*--***---****---
-**--*-**-----*--*
----**-*-*-*--**--
*----*--------***-
******----***---**
-*--*-------*-**-*