*------*-*----
**-*----*-*-*-
--*--*-----*--
-------*---*-*
**-*--**----*-
------*--***-*
*---***-----*-
--*---------**
--------***---
*------*------
---*------*-*-
----*-----*---
*-----*------*
-*--*---------