*---*-*-*---*
-*---*--*---*
***-**-*---**
-****--**--**
***-*----*--*
--*****--****
-***--*----*-
---****-**-*-
-**---*-***-*
****--**----*
***-*--*-*-**
--*--*-**-**-
*-**-*-*-***-
-*--*-**----*