*--*-----
-*-------
**-*-----
----*--**
***--*--*
*-**-*---
*--------
-*--***-*
--*--*-*-
**-------
***-*--*-
---*---*-
--*------
--*--**-*
*-**-----
*-----*-*