*--------*----*---
------------------
------------------
--------------*---
--*--------*-*----
*-*--------*------
---------------*--
------------------
----------*---*---
---------------**-
------------------
-----------------*
-------------*----
------------------
-----------------*
*-----------------
-*----*---*----*--
--*-*-------------
-*------------*---
-*--**---*--------