*---------*
-----------
-----------
-----------
--------**-
-----------
----*-*----
-----------
----------*
----------*
-------*---
----**-*---
----------*
---*-------
-*---------
----*------