*--*---**--*--*-*-*
-********----*-*---
*---**----*-**-*-*-
-----**-------*---*
--*--***-*-**-****-
---*-**-----*------
*----*--**---*-*-*-
*-*--***-*-------**
-*-*--***----------
*--**-*-*-***-*----
*----*----*--*-***-
*-*-**-**-----*-**-