-********--*--**
***-**-**-**--*-
-****-***---**-*
****-***--**-***
*---*---*--****-
*-*******---*-*-
-***-*-*-****-**
--*-******-*****
****--*-**-**-**