-**-**-*-*-
*--**-***-*
****--***-*
*--*-***-*-
*--*---**-*
---*-*-****
-*--*-*--**
--*--**---*
*--*-*---**
*-***--****
--*-*--*---
**-***-----
***-*-**---