-******-*
*--***--*
****----*
--*---***
*--*****-
*--*-*-**
***-***-*
*-*-*****
****-**-*
----*-***
***--****