-*-*----**-----
*-*-------**---
**--*--**--**--
---*----*-*-*-*
--*-----*-**-**
--*-***-*------
***-*-***-*----
--**-**---**---
*-*-----*-*----
--**-*--*----*-