-*-**--**
---*-----
-----*---
--**-*---
---*--*--
---**----
--*------
---------
----*--*-
---*--***
---------
----*-**-
-*--*-*--
*-**--**-
*--***-*-
-------*-
-----*---
-*-----*-