-*-**-***
**-*-*-**
**-***-*-
*-*-*****
-*****-**
**-****-*
--*-*****
*****-***
*********
*********
*-*-*****
****-****
*-*****-*
***-*****
--*******
****-***-
****-****
*-*******