-*-------**
*---*-**---
-*---*--***
**---------
-**-***-*-*
***----*--*
---*---**-*
----****-**
**--*----*-