---*----**--
--------*---
--*-------*-
----------*-
-*--*-------
----*----*--
------------
**----------
---------*-*
----**-*----
--**--*--*--
*---------*-
-----------*