---*---*-**-*
-*-*---------
---*----*-***
**----***----
-------**--**
*------**----