--*------*---
--*----**----
-*-----------
-*-*-*-*-----
----*-**-----
---*------*--
*------------