---*--------
-----------*
-------*--**
---------*--
----**--*--*
----*----*--
--*---*-----
------------
--*---------
**----*----*