----*--*--*---
---*-----**-**
*--**-*--*-*-*
-*--*-*---*--*
--*--*-----***
-------*-*---*
-*-*--*--*----
-*--**--*--*--
--------*--*--
-------****---
-**--*-**----*
------*--**--*
--*----**-----
---**--***-*-*
---*-*-*--*--*