-------*-*-------
--------------*--
----*-----*--**--
----*---*-*-*-*--
-----*----*------
*-*------**----*-
----------*------
-****--*-------*-
---*----------*--
----------**-----
--*---*----------
-*----------*----
***----------*--*
----------------*
---*-----*----*--