-----*-**---------
-*****--*-***--*-*
**--*--*------*---
*-*--*--*--*-*----
--*-*------*----*-
----*---------*---
--------***--*----
--****----**---*-*
*-*-**---*--*-----