-----*-----***-
*-*----*-------
-------**------
-*--------*----
---------------
-----*---------
**-----*-------
---**-*---*----
-*-------------