-----*--*
-*----*--
----***--
***---***
*--**---*
*-*---*--
-*----*--
---------
-----*--*
*--*-----
---*-----
-------*-
-----*---
*---**-*-