----*******-*
**-**-***----
-*--*****-**-
***-*--***-**
**-**********
******--*-*--
*--***-*-***-
-*-**-**--***
***-**-*****-
*******-**-*-
****-**-*---*
****-**---***
*--****-****-
****--*****-*
**-*-********
************-
-*-*******---
*********-*-*
-***--**-**-*
****-********