*****************
*-***********-*--
******-**********
*****************
********--*******
*********-**-****