---------*---*
----*------*--
*-------*-----
----*-*-------
--*-----------
*-------*-----
---*-------*--
*-*-*---------
----------*---
------*-------
---*----*-----